...##################################################...................................................................
...#................................................#...................................................................
...#..###################......###################..#...................................................................
...#..#.................#......#.................#..#...................................................................
...#..#.................#......#.................#..#...................................................................
...#..#........s........#......#.................#..#...................................................................
...#..#.................#......#.................#..#...................................................................
...#..#.................#......#.................#..#...................................................................
...#..#.................#......#.................#..#...................................................................
...#..#.................#......#.................#..#...................................................................
...#..#########+#########......#########+#########..#...................................................................
...#................................................#...#...#...#...#...#...#...#.......................................
...#....................................................................................................................
...#................................................#...#...#...#...#...#...#...#.......................................
...#..#########+#########......#########|#########..#...................................................................
...#..#.................#......#.................#..#...................................................................
...#..#.................#......#.................#..#...................................................................
...#..#.................#......#.................#..#...................................................................
...#..#.................#......#.................#..#...................................................................
...#..#.................#......#.................#..#...................................................................
...#..#.................#......#.................#..#...................................................................
...#..#.................#......#.................#..#...................................................................
...#..###################......###################..#...................................................................
...#................................................#...................................................................
...#######################....#######################...................................................................
........................................................................................................................
........................................................................................................................
.........................#....#.........................................................................................
........................................................................................................................
.........................#....#.........................................................................................
........................................................................................................................
.........................#....#.........................................................................................
........................................................................................................................
.........................#....#.........................................................................................
........................................................................................................................
.........................#....#.........................................................................................
........................................................................................................................
.........................#....#.........................................................................................
........................................................................................................................
........................................................................................................................
........................................................................................................................
........................................................................................................................
........................................................................................................................
........................................................................................................................
........................................................................................................................
........................................................................................................................
........................................................................................................................
........................................................................................................................
........................................................................................................................
........................................................................................................................
........................................................................................................................
........................................................................................................................
........................................................................................................................
........................................................................................................................
........................................................................................................................
........................................................................................................................
........................................................................................................................
........................................................................................................................
........................................................................................................................
........................................................................................................................
